AG - AGFlek
AS - Asonance
BD - Bob Dylan
BT - Buty
CW - Charlie Williams
ETR - Erwin T. Rouse
FM - F. Miller
GC - Glen Campbell
GH - Greenhorns
HB - Hoboes
HH - H. Howard
HT - Hop Trop
HV - Helena Vondráèková
IM - Ivan Mládek
JC - Johny Cash
JD - John Denver
JF - Jiøina Fikejzová
JH - Jaroslav Hutka
JL - J. Nicholls
JN - Jaromír Nohavica
JS - Jiøí Schelinger
JU - Jaroslav Uhlíø
KK - Karel Kryl
KL - Klíè
KP - Karel Plíhal
KTO - K. T. O.
LK - Lokálka
LP - Leon Payne
MPK - Martinova Prázdná Kapsa
MR - Miky Ryvola
ND - Nedvìdi
NZ - Nezmaøi
OL - Olympic
PB - Pavel Bobek
PC - Pacifik
PD - Pavel Dobe¹
PK - Petr Skoumal
PN - Petr Novák
PR - Premiér
PS - Pete Seeger
PV - Pavel Dydoviè
RD - R. Dehr
SA - Samson
SG - Paul Simon + Art Garfunkel
SK - Spirituál Kvintet
SS - Suchý+©litr
TB - The Beatles
TG - T. Gilkyson
TJA - T. J. Arnall
TR - Tornádo
VR - Vlasta Redl
VW - Voskovec+Werich
WD - Wabi Danìk
WM - Waldemar Matu¹ka
WR - Wabi Ryvola
ZA - ®alman
ZS - Zdenìk Svìrák
